aa|aa|Afar
ab|ab|Abkhazian
ae|ae|Avestan
af|af|Afrikaans
ak|ak|Akan
am|am|Amharic
an|an|Aragonese
ar|العَرَبِيَّة|Arabic
as|as|Assamese
av|av|Avaric
ay|ay|Aymara
az|az|Azerbaijani
ba|ba|Bashkir
be|Беларуская|Belarusian
bg|Български|Bulgarian
bh|bh|Bihari languages
bi|bi|Bislama
bm|bm|Bambara
bn|বাংলা|Bengali
bo|bo|Tibetan
br|br|Breton
bs|bs|Bosnian
ca|ca|Catalan
ce|ce|Chechen
ch|ch|Chamorro
co|co|Corsican
cr|cr|Cree
cs|Čeština|Czech
cu|cu|Church Slavic
cv|cv|Chuvash
cy|cy|Welsh
da|da|Danish
de|Deutsch|German
dv|dv|Dhivehi
dz|dz|Dzongkha
ee|ee|Ewe
el|el|Modern Greek (1453-)
en|English|English
eo|eo|Esperanto
es|Español|Spanish
et|et|Estonian
eu|eu|Basque
fa|فارسی|Persian
ff|ff|Fulah
fi|fi|Finnish
fj|fj|Fijian
fo|fo|Faroese
fr|Français|French
fy|fy|Western Frisian
ga|ga|Irish
gd|gd|Scottish Gaelic
gl|gl|Galician
gn|gn|Guarani
gr|Ελληνικά|Greek
gu|gu|Gujarati
gv|gv|Manx
ha|ha|Hausa
he|he|Hebrew
hi|hi|Hindi
ho|ho|Hiri Motu
hr|hr|Croatian
ht|ht|Haitian
hu|hu|Hungarian
hy|hy|Armenian
hz|hz|Herero
ia|ia|Interlingua (International Auxiliary Language Association)
id|id|Indonesian
ie|ie|Interlingue
ig|ig|Igbo
ii|ii|Sichuan Yi
ik|ik|Inupiaq
in|in|Indonesian
io|io|Ido
is|is|Icelandic
it|it|Italian
iu|iu|Inuktitut
iw|iw|Hebrew
ja|日本語|Japanese
ji|ji|Yiddish
jv|jv|Javanese
jw|jw|Javanese
ka|ka|Georgian
kg|kg|Kongo
ki|ki|Kikuyu
kj|kj|Kuanyama
kk|kk|Kazakh
kl|kl|Kalaallisut
km|km|Khmer
kn|kn|Kannada
ko|한국어|Korean
kr|kr|Kanuri
ks|ks|Kashmiri
ku|ku|Kurdish
kv|kv|Komi
kw|kw|Cornish
ky|ky|Kirghiz
la|la|Latin
lb|lb|Luxembourgish
lg|lg|Ganda
li|li|Limburgan
ln|ln|Lingala
lo|lo|Lao
lt|lt|Lithuanian
lu|lu|Luba-Katanga
lv|lv|Latvian
mg|mg|Malagasy
mh|mh|Marshallese
mi|mi|Maori
mk|Македонски|Macedonian
ml|ml|Malayalam
mn|mn|Mongolian
mo|mo|Moldavian
mr|mr|Marathi
ms|ms|Malay (macrolanguage)
mt|mt|Maltese
my|my|Burmese
na|na|Nauru
nb|nb|Norwegian Bokmål
nd|nd|North Ndebele
ne|ne|Nepali (macrolanguage)
ng|ng|Ndonga
nl|nl|Dutch
nn|nn|Norwegian Nynorsk
no|no|Norwegian
nr|nr|South Ndebele
nv|nv|Navajo
ny|ny|Nyanja
oc|oc|Occitan (post 1500)
oj|oj|Ojibwa
om|om|Oromo
or|or|Oriya (macrolanguage)
os|os|Ossetian
pa|pa|Panjabi
pi|pi|Pali
pl|pl|Polish
ps|ps|Pushto
pt|Português|Portuguese
qu|qu|Quechua
rm|rm|Romansh
rn|rn|Rundi
ro|ro|Romanian
ru|Русский|Russian
rw|rw|Kinyarwanda
sa|sa|Sanskrit
sc|sc|Sardinian
sd|sd|Sindhi
se|se|Northern Sami
sg|sg|Sango
sh|sh|Serbo-Croatian
si|si|Sinhala
sk|sk|Slovak
sl|Slovenščina|Slovenian
sm|sm|Samoan
sn|sn|Shona
so|so|Somali
sq|sq|Albanian
sr|Српски|Serbian
ss|ss|Swati
st|st|Southern Sotho
su|su|Sundanese
sv|Svenska|Swedish
sw|sw|Swahili (macrolanguage)
ta|ta|Tamil
te|te|Telugu
tg|tg|Tajik
th|th|Thai
ti|ti|Tigrinya
tk|tk|Turkmen
tl|tl|Tagalog
tn|tn|Tswana
to|to|Tonga (Tonga Islands)
tr|Türkçe|Turkish
ts|ts|Tsonga
tt|tt|Tatar
tw|tw|Twi
ty|ty|Tahitian
ug|ug|Uighur
uk|Українська|Ukrainian
ur|ur|Urdu
uz|Ўзбекча|Uzbek
ve|ve|Venda
vi|vi|Vietnamese
vo|vo|Volapük
wa|wa|Walloon
wo|wo|Wolof
xh|xh|Xhosa
yi|yi|Yiddish
yo|yo|Yoruba
za|za|Zhuang
zh|简体中文|Chinese
zu|zu|Zulu
az-Arab|az-Arab|Azerbaijani in Arabic script
az-Cyrl|az-Cyrl|Azerbaijani in Cyrillic script
az-Latn|az-Latn|Azerbaijani in Latin script
be-Latn|be-Latn|Belarusian in Latin script
bs-Cyrl|bs-Cyrl|Bosnian in Cyrillic script
bs-Latn|bs-Latn|Bosnian in Latin script
de-1901|de-1901|German, traditional orthography
de-1996|de-1996|German, orthography of 1996
de-AT-1901|de-AT-1901|German, Austrian variant, traditional orthography
de-AT-1996|de-AT-1996|German, Austrian variant, orthography of 1996
de-CH-1901|de-CH-1901|German, Swiss variant, traditional orthography
de-CH-1996|de-CH-1996|German, Swiss variant, orthography of 1996
de-DE-1901|de-DE-1901|German, German variant, traditional orthography
de-DE-1996|de-DE-1996|German, German variant, orthography of 1996
en-boont|en-boont|Boontling
en-scouse|en-scouse|Scouse
es-419|es-419|Latin American Spanish
iu-Cans|iu-Cans|Inuktitut in Canadian Aboriginal Syllabic script
iu-Latn|iu-Latn|Inuktitut in Latin script
mn-Cyrl|mn-Cyrl|Mongolian in Cyrillic script
mn-Mong|mn-Mong|Mongolian in Mongolian script
sl-nedis|sl-nedis|Natisone dialect, Nadiza dialect
sl-rozaj|sl-rozaj|Resian, Resianic, Rezijan
sr-Cyrl|sr-Cyrl|Serbian in Cyrillic script
sr-Latn|sr-Latn|Serbian in Latin script
tg-Arab|tg-Arab|Tajik in Arabic script
tg-Cyrl|tg-Cyrl|Tajik in Cyrillic script
uz-Cyrl|uz-Cyrl|Uzbek in Cyrillic script
uz-Latn|uz-Latn|Uzbek in Latin script
yi-Latn|yi-Latn|Yiddish, in Latin script
zh-cmn|zh-cmn|Mandarin Chinese
zh-cmn-Hans|zh-cmn-Hans|Mandarin Chinese (Simplified)
zh-cmn-Hant|zh-cmn-Hant|Mandarin Chinese (Traditional)
zh-gan|zh-gan|Kan or Gan
zh-Hans|简体中文|simplified Chinese
zh-Hans-CN|zh-Hans-CN|PRC Mainland Chinese in simplified script
zh-Hans-HK|zh-Hans-HK|Hong Kong Chinese in simplified script
zh-Hans-MO|zh-Hans-MO|Macao Chinese in simplified script
zh-Hans-SG|zh-Hans-SG|Singapore Chinese in simplified script
zh-Hans-TW|繁體中文|Taiwan Chinese in simplified script
zh-Hant|zh-Hant|traditional Chinese
zh-Hant-CN|zh-Hant-CN|PRC Mainland Chinese in traditional script
zh-Hant-HK|zh-Hant-HK|Hong Kong Chinese in traditional script
zh-Hant-MO|zh-Hant-MO|Macao Chinese in traditional script
zh-Hant-SG|zh-Hant-SG|Singapore Chinese in traditional script
zh-Hant-TW|zh-Hant-TW|Taiwan Chinese in traditional script
zh-wuu|zh-wuu|Shanghaiese or Wu
zh-yue|zh-yue|Cantonese